111111111111
110010010011
110000001011
10010#010101
101000000101
111000000101
101010010101
110010000111
1110100@0011
100001000001
100001011101